**xxxx****
x**x***xx*
*x***xxxx*
**x*x**x**
*x**xx*x*x
***x*x*x**
xx*x****x*
x**xx*x***
**x*x*xxx*
*xx*****x*